111111111111
100000000001
101111101101
101100101001
111110100011
100010100001
110000001011
110011101111
111000000001
100011101111
111111111111