1111111111111111111
1000001000000010001
1011111010101110101
101..........1.....
101..........1.....
1000001......1.....
11111010111111.....
...................
...................
...................
...................
...................
...................
...................
...................
...................
...................
...................

## i'm not going to finish this one
