111111111111
100000000001
100110001101
100110011101
100110000001
100000011111
100110011111
100110000001
100111000001
100000000111
111111111111